 Австралия — Австралийский Союз
 Австрия — Австрийская Республика
 Азербайджан — Азербайджанская Республика
 Албания — Республика Албания
 Алжир — Алжирская Народная Демократическая Республика
 Ангола — Республика Ангола
 Андорра — Княжество Андорра
 Антигуа и Барбуда — Антигуа и Барбуда
 Аргентина — Аргентинская Республика
 Армения — Республика Армения
 Афганистан — Исламская Республика Афганистан
 Багамские Острова — Содружество Багамских Островов
 Бангладеш — Народная Республика Бангладеш
 Барбадос — Барбадос
 Бахрейн — Королевство Бахрейн
 Белоруссия — Республика Беларусь
 Белиз — Белиз
 Бельгия — Королевство Бельгия
 Бенин — Республика Бенин
 Болгария — Республика Болгария
 Боливия — Многонациональное Государство Боливия
 Босния и Герцеговина — Босния и Герцеговина
 Ботсвана — Республика Ботсвана
 Бразилия — Федеративная Республика Бразилия
 Бруней — Государство Бруней-Даруссалам
 Буркина-Фасо — Буркина-Фасо
 Бурунди — Республика Бурунди
 Бутан — Королевство Бутан
 Вануату — Республика Вануату
 Великобритания — Соединённое Королевство Великобритании и Северной Ирландии
 Венгрия — Венгрия
 Венесуэла — Боливарианская Республика Венесуэла
 Восточный Тимор — Демократическая Республика Восточный Тимор
 Вьетнам — Социалистическая Республика Вьетнам
 Габон — Габонская Республика
 Гаити — Республика Гаити
 Гайана — Кооперативная Республика Гайана
 Гамбия — Республика Гамбия
 Гана — Республика Гана
 Гватемала — Республика Гватемала
 Гвинея — Гвинейская Республика
 Гвинея-Бисау — Республика Гвинея-Бисау
 Германия — Федеративная Республика Германия
 Гондурас — Республика Гондурас
 Гренада — Гренада
 Греция — Греческая Республика
 Грузия — Грузия
 Дания — Королевство Дания
 Джибути — Республика Джибути
 Доминика — Содружество Доминики
 Доминиканская Республика — Доминиканская Республика
 Египет — Арабская Республика Египет
 Замбия — Республика Замбия
 Зимбабве — Республика Зимбабве
 Израиль — Государство Израиль
 Индия — Республика Индия
 Индонезия — Республика Индонезия
 Иордания — Иорданское Хашимитское Королевство
 Ирак — Республика Ирак
 Иран — Исламская Республика Иран
 Ирландия — Ирландия
 Исландия — Исландия
 Испания — Королевство Испания
 Италия — Итальянская Республика
 Йемен — Йеменская Республика
 Кабо-Верде — Республика Кабо-Верде
 Казахстан — Республика Казахстан
 Камбоджа — Королевство Камбоджа
 Камерун — Республика Камерун
 Канада — Канада
 Катар — Государство Катар
 Кения — Республика Кения
 Кипр — Республика Кипр
 Киргизия — Киргизская Республика (Кыргызская Республика)
 Кирибати — Республика Кирибати
 Китай — Китайская Народная Республика
 Колумбия — Республика Колумбия
 Коморы — Союз Коморских Островов
 Республика Конго — Республика Конго
 Демократическая Республика Конго — Демократическая Республика Конго
 КНДР — Корейская Народно-Демократическая Республика (Северная Корея)
 Республика Корея — Республика Корея (Южная Корея — неофициальное название, широко употребляемое в СМИ)
 Коста-Рика — Республика Коста-Рика
 Кот-д’Ивуар — Республика Кот-д’Ивуар
 Куба — Республика Куба
 Кувейт — Государство Кувейт
 Лаос — Лаосская Народно-Демократическая Республика
 Латвия — Латвийская Республика
 Лесото — Королевство Лесото
 Либерия — Республика Либерия
 Ливан — Ливанская Республика
 Ливия — Ливия
 Литва — Литовская Республика
 Лихтенштейн — Княжество Лихтенштейн
 Люксембург — Великое Герцогство Люксембург
 Маврикий — Республика Маврикий
 Мавритания — Исламская Республика Мавритания
 Мадагаскар — Республика Мадагаскар
 Малави — Республика Малави
 Малайзия — Малайзия
 Мали — Республика Мали
 Мальдивы — Мальдивская Республика
 Мальта — Республика Мальта
 Марокко — Королевство Марокко
 Маршалловы Острова — Республика Маршалловы Острова
 Мексика — Мексиканские Соединенные Штаты
 Мозамбик — Республика Мозамбик
 Молдавия — Республика Молдова