 Монако — Княжество Монако
 Монголия — Монголия
 Мьянма — Республика Союз Мьянма[1]
 Намибия — Республика Намибия
 Науру — Республика Науру
 Непал — Федеративная Демократическая Республика Непал
 Нигер — Республика Нигер
 Нигерия — Федеративная Республика Нигерия
 Нидерланды — Королевство Нидерландов
 Никарагуа — Республика Никарагуа
 Новая Зеландия — Новая Зеландия
 Норвегия — Королевство Норвегия
 ОАЭ — Объединённые Арабские Эмираты
 Оман — Султанат Оман
 Пакистан — Исламская Республика Пакистан
 Палау — Республика Палау
 Панама — Республика Панама
 Папуа — Новая Гвинея — Независимое Государство Папуа — Новая Гвинея
 Парагвай — Республика Парагвай
 Перу — Республика Перу
 Польша — Республика Польша
 Португалия — Португальская Республика
 Россия — Российская Федерация
 Руанда — Республика Руанда
 Румыния — Румыния
 Сальвадор — Республика Эль-Сальвадор
 Самоа — Независимое Государство Самоа
 Сан-Марино — Республика Сан-Марино
 Сан-Томе и Принсипи — Демократическая Республика Сан-Томе и Принсипи
 Саудовская Аравия — Королевство Саудовская Аравия
 Свазиленд — Королевство Эсватини
 Северная Македония — Республика Северная Македония
 Сейшельские Острова — Республика Сейшельские Острова
 Сенегал — Республика Сенегал
 Сент-Винсент и Гренадины — Сент-Винсент и Гренадины
 Сент-Китс и Невис — Федерация Сент-Китс и Невис
 Сент-Люсия — Сент-Люсия
 Сербия — Республика Сербия
 Сингапур — Республика Сингапур
 Сирия — Сирийская Арабская Республика
 Словакия — Словацкая Республика
 Словения — Республика Словения
 США — Соединённые Штаты Америки
 Соломоновы Острова — Соломоновы Острова
 Сомали — Федеративная Республика Сомали
 Судан — Республика Судан
 Суринам — Республика Суринам
 Сьерра-Леоне — Республика Сьерра-Леоне
 Таджикистан — Республика Таджикистан
 Таиланд — Королевство Таиланд
 Танзания — Объединённая Республика Танзания
 Того — Тоголезская Республика
 Тонга — Королевство Тонга
 Тринидад и Тобаго — Республика Тринидад и Тобаго
 Тувалу — Тувалу
 Тунис — Тунисская Республика
 Туркмения — Туркменистан
 Турция — Турецкая Республика
 Уганда — Республика Уганда
 Узбекистан — Республика Узбекистан
 Украина — Украина
 Уругвай — Восточная Республика Уругвай
 Федеративные Штаты Микронезии — Федеративные Штаты Микронезии
 Фиджи — Республика Островов Фиджи
 Филиппины — Республика Филиппины
 Финляндия — Финляндская Республика
 Франция — Французская Республика
 Хорватия — Республика Хорватия
 Центральноафриканская Республика — Центральноафриканская Республика
 Чад — Республика Чад
 Черногория — Черногория
 Чехия — Чешская Республика
 Чили — Республика Чили
 Швейцария — Швейцарская Конфедерация
 Швеция — Королевство Швеция
 Шри-Ланка — Демократическая Социалистическая Республика Шри-Ланка
 Эквадор — Республика Эквадор
 Экваториальная Гвинея — Республика Экваториальная Гвинея
 Эритрея — Государство Эритрея
 Эстония — Эстонская Республика
 Эфиопия — Федеративная Демократическая Республика Эфиопия
 ЮАР — Южно-Африканская Республика
 Южный Судан — Республика Южный Судан
 Ямайка — Ямайка
 Япония — Япония